XXXXXXXXXXXX
X         HX
X          X
X          X
X          X
XXXXXXXXXXXX
