XXXXXXXXXXXXXXXXXXXXXXXXXXXXXXXXXXXXXXXXXXXXXXXXXXXXXXXXXXXX
X    H     X                                               X
X          X                                               X
X          X                                               X
X F   F    X                          *                    X
X                                                          X
X          ***                                             X
X                                                          X
X                                                          X
XXXXXXXXXXXXXXXXXXXXXXXXXXXXXXXXXXXXXXXXXXXXXXXXXXXXXXXXXXXX
